,Y0,Y1,Y2,Y3,Y4,Y5,Y6,Y7,Y8,Y9
0,0,0,0,0,0,0,0,0,0,0
1,0,0,0,0,0,0,0,0,0,0
2,0,0,0,0,2,2,0,0,0,0
3,0,0,0,2,2,2,2,0,0,0
4,0,0,0,1,1,1,1,0,0,0
5,0,0,0,1,1,1,1,0,0,0
6,0,0,0,1,1,1,1,0,0,0
7,0,0,1,1,1,1,1,1,0,0
8,0,1,1,1,1,1,1,1,1,0
9,0,1,1,1,1,1,1,1,1,0