,Y0,Y1,Y2,Y3,Y4,Y5,Y6,Y7,Y8,Y9
0,0,0,0,0,0,0,0,0,0,0
1,0,0,0,0,0,0,0,0,0,0
2,1,1,1,1,1,1,1,1,1,1
3,1,1,1,2,1,1,1,1,1,1
4,1,1,1,2,1,1,1,1,1,1
5,1,1,1,1,1,1,2,1,1,1
6,1,1,1,1,1,1,2,1,1,1
7,1,1,1,1,1,1,1,1,1,1
8,0,0,0,0,0,0,0,0,0,0
9,0,0,0,0,0,0,0,0,0,0