,Y0,Y1,Y2,Y3,Y4,Y5,Y6,Y7,Y8,Y9
0,0,0,0,0,0,0,0,0,0,0
1,0,0,0,0,0,0,0,0,0,0
2,0,1,1,1,0,0,1,1,1,0
3,0,1,2,1,0,0,1,1,1,0
4,0,1,1,1,1,1,1,1,1,0
5,0,1,1,1,1,1,1,1,1,0
6,0,1,1,1,0,0,1,2,1,0
7,0,1,1,1,0,0,1,1,1,0
8,0,0,0,0,0,0,0,0,0,0
9,0,0,0,0,0,0,0,0,0,0